1111111111111111111111111111111111
1E0000000000000C00000C000110000001
1010010100100000101001001001000011
10100100101010100P1001000110000011
100000000C00C0000000000000000000C1
1111111111111111111111111111111111