111111111111111111111111111111111
1000000C00000000P00000000000000C1
100101010000000000000000010101001
1C1010101000000000000000101010101
100000000000000000000000000000001
100101010000010101010000010101001
10101C101000101010101000101010101
100000000000000C000000000000C0001
1001C10100000101010100000101C1001
101010101000101010101000101010101
100000000000000000000000000000001
10010101000001010101000001C101001
1010101C1000101010101000101010101
1000000000000000000000000C0000001
100101010000010101010000010101001
101010100000101010101000101010101
1000000000000C0000000000000000001
10010101000001010101000001C101001
10101C100000101010101000101010101
100C00000000000000000000000000001
100101010000010101010000010101001
1C1010101000101010101000101010101
100000000000000000000000000000001
1001010100000101010100000101010C1
10101010100010101C101000101010101
1000000000000C0000000000000000001
100101010000000000000000010101001
101010101000000000000000101010101
1000000000C00000E00000000000000C1
111111111111111111111111111111111