1111111111111111111111111111111111111111111111111111111111111111111111111111111
1P00000000000000C00000000000000001111111111111111111111111111111111111111111111
1010010100100000101001000000C10101111111111111111111111111111111111111111111111
1010010010101010001001000000010101111111111111111111111111111111111111111111111
1000000000000000000000000000000001111111111111111111111111111111111111111111111
1010010010101010001001000000010101111111111111111111111111111111111111111111111
1000000000000000000000000000000001111111111111111111111111111111111111111111111
1000010000000000000000000001000001111111111111111111111111111111111111111111111
1111111111110000000000000000000001111111111111111111111111111111111111111111111
1111000000000001110000000000000001111111111111111111111111111111111111111111111
1100000000000111000000000000000001111111111111111111111111111111111111111111111
1000000000000000000000000000000001111111111111111111111111111111111111111111111
1000000000000000000000000000000001111111111111111111111111111111111111111111111
1111000000000000000000000000001111111111111111111111111111111111111111111111111
1000000000000000000000000001111111111111111111111111111111111111111111111111111
1111111111110000000000000111111111111111111111111111111111111111111111111111111
1111000000000000000000000000001111111111111111111111111111111111111111111111111
1000000000000000000000000000000001111111111111111111111111111111111111111111111
10000000000000000000000000000000E1111111111111111111111111111111111111111111111
1111111111111111111111111111111111111111111111111111111111111111111111111111111