111111111111111111111111111111111111111111111111111111111111111111111111111111111111111111111111111
1P00000000000000C0000000000000000111111111111111111111111111111111111111111111111111111111111111111
1010010100100000101001000000C1010111111111111111111111111111111111111111111111111111111111111111111
101001001010101000100100000001010111111111111111111111111111111111111111111111111111111111111111111
100000000000000000000000000000000111111111111111111111111111111111111111111111111111111111111111111
101001001010101000100100000001010111111111111111111111111111111111111111111111111111111111111111111
100000000000000000000000000000000111111111111111111111111111111111111111111111111111111111111111111
100001000000000000000000000100000111111111111111111111111111111111111111111111111111111111111111111
111111111111000000000000000000000111111111111111111111111111111111111111111111111111111111111111111
111100000000000111000000000000000111111111111111111111111111111111111111111111111111111111111111111
110000000000011100000000000000000111111111111111111111111111111111111111111111111111111111111111111
100000000000000000000000000000000111111111111111111111111111111111111111111111111111111111111111111
100000000000000000000000000000000111111111111111111111111111111111111111111111111111111111111111111
111100000000000000000000000000111111111111111111111111111111111111111111111111111111111111111111111
100000000000000000000000000111111111111111111111111111111111111111111111111111111111111111111111111
111111111111000000000000011111111111111111111111111111111111111111111111111111111111111111111111111
111100000000000000000000000000111111111111111111111111111111111111111111111111111111111111111111111
100000000000000000000000000000000111111111111111111111111111111111111111111111111111111111111111111
10000000000000000000000000000000E111111111111111111111111111111111111111111111111111111111111111111
111100000000000111000000000000000111111111111111111111111111111111111111111111111111111111111111111
110000000000011100000000000000000111111111111111111111111111111111111111111111111111111111111111111
100000000000000000000000000000000111111111111111111111111111111111111111111111111111111111111111111
100000000000000000000000000000000111111111111111111111111111111111111111111111111111111111111111111
111100000000000000000000000000111111111111111111111111111111111111111111111111111111111111111111111
100000000000000000000000000111111111111111111111111111111111111111111111111111111111111111111111111
111111111111000000000000011111111111111111111111111111111111111111111111111111111111111111111111111
111100000000000000000000000000111111111111111111111111111111111111111111111111111111111111111111111
100000000000000000000000000000000111111111111111111111111111111111111111111111111111111111111111111
10000000000000000000000000000000E111111111111111111111111111111111111111111111111111111111111111111
111100000000000111000000000000000111111111111111111111111111111111111111111111111111111111111111111
110000000000011100000000000000000111111111111111111111111111111111111111111111111111111111111111111
100000000000000000000000000000000111111111111111111111111111111111111111111111111111111111111111111
100000000000000000000000000000000111111111111111111111111111111111111111111111111111111111111111111
111100000000000000000000000000111111111111111111111111111111111111111111111111111111111111111111111
100000000000000000000000000111111111111111111111111111111111111111111111111111111111111111111111111
111111111111000000000000011111111111111111111111111111111111111111111111111111111111111111111111111
111100000000000000000000000000111111111111111111111111111111111111111111111111111111111111111111111
100000000000000000000000000000000111111111111111111111111111111111111111111111111111111111111111111
10000000000000000000000000000000E111111111111111111111111111111111111111111111111111111111111111111
111111111111000000000000011111111111111111111111111111111111111111111111111111111111111111111111111
111100000000000000000000000000111111111111111111111111111111111111111111111111111111111111111111111
100000000000000000000000000000000111111111111111111111111111111111111111111111111111111111111111111
10000000000000000000000000000000E111111111111111111111111111111111111111111111111111111111111111111
111111111111000000000000011111111111111111111111111111111111111111111111111111111111111111111111111
111100000000000000000000000000111111111111111111111111111111111111111111111111111111111111111111111
100000000000000000000000000000000111111111111111111111111111111111111111111111111111111111111111111
10000000000000000000000000000000E111111111111111111111111111111111111111111111111111111111111111111
111111111111111111111111111111111111111111111111111111111111111111111111111111111111111111111111111