111111111111111111111
1P000000010000000C101
101101110101110110101
101101110101110110101
100000000000000000101
101101011111010110101
100001000100010000101
111101110101110111101
110101000000010101101
110101011011010101101
110000010E01000001101
110101011111010101101
110101000000010101101
111101011111010111101
100000000100000000101
101101110101110110101
100100000000000100101
110101011111010101101
100001000100010000101
101111110101111110101
1C000000000000000C101
111111111111111111111