11111111111111111111111111111
1P000000010000000C11111111111
10110111010111011011111111111
10110111010111011011111111111
10000000000000000011111111111
10110101111101011011111111111
10000100010001000011111111111
11110111010111011111111111111
11010100000001010111111111111
11010101101101010111111111111
110000010E0100000111111111111
11010101111101010111111111111
11010100000001010111111111111
11110101111101011111111111111
10000000010000000011111111111
10110111010111011011111111111
10010000000000010011111111111
11010101111101010111111111111
10000100010001000011111111111
10111111010111111011111111111
1C000000000000000C11111111111
11111111111111111111111111111