1111111111111111111
1P000000010000000C1
1011011101011101101
1011011101011101101
1000000000000000001
1011010111110101101
1000010001000100001
1111011101011101111
1101010000000101011
1101010110110101011
110000010E010000011
1101010111110101011
1101010000000101011
1111010111110101111
1000000001000000001
1011011101011101101
1001000000000001001
1101010111110101011
1000010001000100001
1011111101011111101
1C000000000000000C1
1001000000000001001
1001000000000001001
1001000000000001001
1001000000000001001
1001000000000001001
1001000000000001001
1001000000000001001
1001000000000001001
1111111111111111111